{
  "name": "Namuna Xarita - Labirint",
  "description": "10x10 grid, 1=yo'l, 0=devor",
  "cell_size": 1.0,
  "start": [0, 0],
  "end": [9, 9],
  "map": [
    [1, 1, 1, 0, 0, 0, 1, 1, 1, 1],
    [0, 0, 1, 0, 1, 0, 1, 0, 0, 1],
    [1, 0, 1, 1, 1, 0, 1, 0, 0, 1],
    [1, 0, 0, 0, 1, 0, 1, 1, 0, 1],
    [1, 1, 1, 0, 1, 0, 0, 1, 0, 1],
    [0, 0, 1, 0, 1, 1, 1, 1, 0, 1],
    [0, 0, 1, 0, 0, 0, 0, 1, 0, 1],
    [0, 0, 1, 1, 1, 0, 0, 1, 1, 1],
    [0, 0, 0, 0, 1, 0, 0, 0, 0, 1],
    [0, 0, 0, 0, 1, 1, 1, 1, 1, 1]
  ]
}
