{
  "name": "Oddiy To'g'ri Yo'l",
  "description": "5x10 grid, to'g'ri yo'l bilan test",
  "cell_size": 1.0,
  "start": [2, 0],
  "end": [2, 9],
  "map": [
    [0, 0, 0, 0, 0, 0, 0, 0, 0, 0],
    [0, 1, 1, 1, 1, 1, 1, 1, 1, 0],
    [1, 1, 1, 1, 1, 1, 1, 1, 1, 1],
    [0, 1, 1, 1, 1, 1, 1, 1, 1, 0],
    [0, 0, 0, 0, 0, 0, 0, 0, 0, 0]
  ]
}
